DOWN	D AW N
GO	G OW
HA	HH AA
HEE	HH IY
HELLO	HH AH L OW
HELLO(2)	HH EH L OW
LEFT	L EH F T
MARCY	M AA R S IY
OFF	AO F
ON	AA N
ON(2)	AO N
POOP	P UW P
RIGHT	R AY T
SELECT	S AH L EH K T
SOURCE	S AO R S
TO	T UW
TO(2)	T IH
TO(3)	T AH
TURN	T ER N
TV	T IY V IY
TV(2)	T EH L AH V IH ZH AH N
UP	AH P
